###########
#####@#####
###^ $ ^###
##^     ^##
#         #
#### . ####
###########