#########
#.#####.#
#       #
#  $ $  #
#^  @  ^#
#  $ $  #
#       #
#.     .#
#########