#######
##. .##
#.$$$.#
# $@$ #
#.$$$.#
##. .##
#######