########
#.  $ .#
#.$$$$.#
#. @$ .#
########